the driver exercises really really really really really really really perfectly .	the driver is really really really really really really really perfectly .
the patient cries really really really really really really really really really perfectly .	the patient is really really really really really really really really really perfectly .
the guy exercises very very very very very very very very quietly .	the guy was very very very very very very very very quietly .
the adult paints really really really really really really really really really carefully .	the adult was really really really really really really really really really carefully .
the adult waves really really really really really really really carefully .	the adult is really really really really really really really carefully .
the dancer sings really really really really really really really really really really carefully .	the dancer was really really really really really really really really really really carefully .
the customer cries really really really really really really really slowly .	the customer is really really really really really really really slowly .
the guy exercises really really really really really really really really really really quickly .	the guy was really really really really really really really really really really quickly .
the patient talks really really really really really really really really really really perfectly .	the patient was really really really really really really really really really really perfectly .
the girl waves very very very very very very very very very slowly .	the girl is very very very very very very very very very slowly .
the doctor paints very very very very very very very very very quickly .	the doctor is very very very very very very very very very quickly .
the child cries really really really really really really really really really really quickly .	the child is really really really really really really really really really really quickly .
the adult waves really really really really really really really really quietly .	the adult is really really really really really really really really quietly .
the customer reads very very very very very very very very very perfectly .	the customer was very very very very very very very very very perfectly .
the customer waves really really really really really really really really really really quietly .	the customer was really really really really really really really really really really quietly .
the man talks really really really really really really really really quietly .	the man was really really really really really really really really quietly .
the guy talks very very very very very very very quickly .	the guy is very very very very very very very quickly .
the patient talks really really really really really really really really really really quickly .	the patient is really really really really really really really really really really quickly .
the girl exercises really really really really really really really really quietly .	the girl is really really really really really really really really quietly .
the girl talks really really really really really really really really really perfectly .	the girl was really really really really really really really really really perfectly .
the woman reads very very very very very very very very very very slowly .	the woman was very very very very very very very very very very slowly .
the guy cries really really really really really really really really really really quietly .	the guy is really really really really really really really really really really quietly .
the adult paints very very very very very very very very quickly .	the adult is very very very very very very very very quickly .
the dancer exercises really really really really really really really really slowly .	the dancer is really really really really really really really really slowly .
the driver reads really really really really really really really quietly .	the driver is really really really really really really really quietly .
the customer reads very very very very very very very very very quietly .	the customer was very very very very very very very very very quietly .
the adult cries very very very very very very very slowly .	the adult was very very very very very very very slowly .
the dancer sings very very very very very very very very quietly .	the dancer is very very very very very very very very quietly .
the dentist cries very very very very very very very very very quietly .	the dentist was very very very very very very very very very quietly .
the patient reads very very very very very very very very quickly .	the patient was very very very very very very very very quickly .
the adult waves really really really really really really really slowly .	the adult was really really really really really really really slowly .
the dancer paints very very very very very very very very perfectly .	the dancer was very very very very very very very very perfectly .
the dancer paints very very very very very very very very very quickly .	the dancer is very very very very very very very very very quickly .
the guy sings really really really really really really really really really really quickly .	the guy was really really really really really really really really really really quickly .
the guy waves really really really really really really really really really really perfectly .	the guy was really really really really really really really really really really perfectly .
the teacher waves really really really really really really really really really really perfectly .	the teacher is really really really really really really really really really really perfectly .
the driver reads really really really really really really really really quickly .	the driver was really really really really really really really really quickly .
the boy waves really really really really really really really really carefully .	the boy was really really really really really really really really carefully .
the teacher talks very very very very very very very carefully .	the teacher is very very very very very very very carefully .
the dentist sings very very very very very very very very very quickly .	the dentist was very very very very very very very very very quickly .
the queen reads very very very very very very very very very very slowly .	the queen is very very very very very very very very very very slowly .
the man exercises very very very very very very very very very very quietly .	the man is very very very very very very very very very very quietly .
the adult reads really really really really really really really quickly .	the adult is really really really really really really really quickly .
the person paints really really really really really really really really slowly .	the person was really really really really really really really really slowly .
the person waves very very very very very very very very very quickly .	the person is very very very very very very very very very quickly .
the child exercises really really really really really really really really really carefully .	the child was really really really really really really really really really carefully .
the king reads really really really really really really really really quickly .	the king was really really really really really really really really quickly .
the girl sings really really really really really really really really perfectly .	the girl is really really really really really really really really perfectly .
the child sings very very very very very very very very very quickly .	the child is very very very very very very very very very quickly .
the doctor paints very very very very very very very very very very slowly .	the doctor was very very very very very very very very very very slowly .
the patient waves very very very very very very very very very carefully .	the patient was very very very very very very very very very carefully .
the dentist cries really really really really really really really really slowly .	the dentist is really really really really really really really really slowly .
the king reads really really really really really really really really really perfectly .	the king is really really really really really really really really really perfectly .
the girl waves very very very very very very very very very carefully .	the girl is very very very very very very very very very carefully .
the boy paints really really really really really really really really quietly .	the boy was really really really really really really really really quietly .
the dancer talks really really really really really really really really really really carefully .	the dancer is really really really really really really really really really really carefully .
the doctor sings very very very very very very very very very very quickly .	the doctor is very very very very very very very very very very quickly .
the patient sings really really really really really really really really really quietly .	the patient is really really really really really really really really really quietly .
the teacher waves really really really really really really really really really quietly .	the teacher is really really really really really really really really really quietly .
the person sings very very very very very very very very very very perfectly .	the person is very very very very very very very very very very perfectly .
the customer waves really really really really really really really quickly .	the customer was really really really really really really really quickly .
the king sings very very very very very very very perfectly .	the king was very very very very very very very perfectly .
the queen waves really really really really really really really really perfectly .	the queen was really really really really really really really really perfectly .
the dancer paints really really really really really really really really carefully .	the dancer is really really really really really really really really carefully .
the woman waves very very very very very very very very very very slowly .	the woman is very very very very very very very very very very slowly .
the driver talks very very very very very very very very slowly .	the driver was very very very very very very very very slowly .
the customer waves really really really really really really really really really really carefully .	the customer was really really really really really really really really really really carefully .
the boy reads very very very very very very very very very quickly .	the boy was very very very very very very very very very quickly .
the woman talks really really really really really really really really slowly .	the woman was really really really really really really really really slowly .
the driver exercises really really really really really really really quietly .	the driver is really really really really really really really quietly .
the child cries really really really really really really really carefully .	the child was really really really really really really really carefully .
the lady sings really really really really really really really really really quietly .	the lady is really really really really really really really really really quietly .
the doctor sings really really really really really really really really quietly .	the doctor was really really really really really really really really quietly .
the girl cries very very very very very very very very carefully .	the girl is very very very very very very very very carefully .
the boy paints very very very very very very very very perfectly .	the boy is very very very very very very very very perfectly .
the person talks really really really really really really really really really really carefully .	the person was really really really really really really really really really really carefully .
the lady sings really really really really really really really really really slowly .	the lady was really really really really really really really really really slowly .
the adult reads very very very very very very very very carefully .	the adult is very very very very very very very very carefully .
the woman paints really really really really really really really really carefully .	the woman was really really really really really really really really carefully .
the customer waves really really really really really really really really really really quietly .	the customer is really really really really really really really really really really quietly .
the teacher sings really really really really really really really really quietly .	the teacher was really really really really really really really really quietly .
the dancer talks very very very very very very very very quickly .	the dancer is very very very very very very very very quickly .
the driver cries very very very very very very very very quickly .	the driver was very very very very very very very very quickly .
the lady exercises really really really really really really really quickly .	the lady was really really really really really really really quickly .
the dentist cries really really really really really really really really perfectly .	the dentist is really really really really really really really really perfectly .
the lady reads very very very very very very very very carefully .	the lady was very very very very very very very very carefully .
the guy cries really really really really really really really quietly .	the guy was really really really really really really really quietly .
the child cries very very very very very very very quickly .	the child is very very very very very very very quickly .
the dentist talks really really really really really really really really quietly .	the dentist is really really really really really really really really quietly .
the adult waves very very very very very very very very very perfectly .	the adult was very very very very very very very very very perfectly .
the person exercises very very very very very very very very very quickly .	the person is very very very very very very very very very quickly .
the dancer cries very very very very very very very very very quickly .	the dancer is very very very very very very very very very quickly .
the guy cries really really really really really really really really really quietly .	the guy was really really really really really really really really really quietly .
the customer waves really really really really really really really carefully .	the customer is really really really really really really really carefully .
the doctor talks really really really really really really really really really quietly .	the doctor was really really really really really really really really really quietly .
the doctor sings very very very very very very very very carefully .	the doctor is very very very very very very very very carefully .
the king sings very very very very very very very very very very perfectly .	the king is very very very very very very very very very very perfectly .
the doctor reads really really really really really really really perfectly .	the doctor is really really really really really really really perfectly .
the dancer cries really really really really really really really really really quietly .	the dancer was really really really really really really really really really quietly .
the queen reads very very very very very very very very carefully .	the queen was very very very very very very very very carefully .
the teacher cries really really really really really really really really really perfectly .	the teacher was really really really really really really really really really perfectly .
the dancer reads really really really really really really really really really really carefully .	the dancer was really really really really really really really really really really carefully .
the doctor paints really really really really really really really really really really quickly .	the doctor is really really really really really really really really really really quickly .
the man reads very very very very very very very very very very quickly .	the man was very very very very very very very very very very quickly .
the king cries very very very very very very very very very perfectly .	the king was very very very very very very very very very perfectly .
the doctor cries very very very very very very very quickly .	the doctor is very very very very very very very quickly .
the girl reads very very very very very very very very very quickly .	the girl is very very very very very very very very very quickly .
the king paints really really really really really really really really quickly .	the king was really really really really really really really really quickly .
the man exercises really really really really really really really really really really quietly .	the man is really really really really really really really really really really quietly .
the doctor cries very very very very very very very very quietly .	the doctor is very very very very very very very very quietly .
the girl reads very very very very very very very slowly .	the girl was very very very very very very very slowly .
the queen exercises very very very very very very very very perfectly .	the queen is very very very very very very very very perfectly .
the girl reads very very very very very very very very very very carefully .	the girl is very very very very very very very very very very carefully .
the dentist exercises really really really really really really really really really quickly .	the dentist was really really really really really really really really really quickly .
the teacher sings really really really really really really really really really really quickly .	the teacher is really really really really really really really really really really quickly .
the king cries very very very very very very very very very very slowly .	the king was very very very very very very very very very very slowly .
the adult reads really really really really really really really really quietly .	the adult is really really really really really really really really quietly .
the customer talks really really really really really really really really carefully .	the customer was really really really really really really really really carefully .
the queen sings very very very very very very very quickly .	the queen was very very very very very very very quickly .
the guy cries very very very very very very very very very very quickly .	the guy is very very very very very very very very very very quickly .
the customer reads really really really really really really really really really really slowly .	the customer is really really really really really really really really really really slowly .
the adult waves very very very very very very very very slowly .	the adult was very very very very very very very very slowly .
the boy exercises very very very very very very very very very very slowly .	the boy was very very very very very very very very very very slowly .
the queen waves very very very very very very very slowly .	the queen was very very very very very very very slowly .
the dentist reads very very very very very very very very quickly .	the dentist is very very very very very very very very quickly .
the adult exercises really really really really really really really really really perfectly .	the adult was really really really really really really really really really perfectly .
the girl sings really really really really really really really really really perfectly .	the girl was really really really really really really really really really perfectly .
the child paints really really really really really really really really slowly .	the child was really really really really really really really really slowly .
the guy reads very very very very very very very very very very perfectly .	the guy was very very very very very very very very very very perfectly .
the adult cries very very very very very very very very carefully .	the adult is very very very very very very very very carefully .
the doctor paints very very very very very very very very quickly .	the doctor was very very very very very very very very quickly .
the king cries very very very very very very very very perfectly .	the king is very very very very very very very very perfectly .
the adult waves really really really really really really really really really really slowly .	the adult is really really really really really really really really really really slowly .
the adult reads very very very very very very very very very very carefully .	the adult is very very very very very very very very very very carefully .
the teacher sings really really really really really really really really carefully .	the teacher is really really really really really really really really carefully .
the lady paints very very very very very very very very very very carefully .	the lady was very very very very very very very very very very carefully .
the king cries very very very very very very very quickly .	the king was very very very very very very very quickly .
the patient reads very very very very very very very very very very carefully .	the patient is very very very very very very very very very very carefully .
the patient waves very very very very very very very very very very quickly .	the patient is very very very very very very very very very very quickly .
the lady paints really really really really really really really really really quietly .	the lady is really really really really really really really really really quietly .
the person sings very very very very very very very very quietly .	the person was very very very very very very very very quietly .
the dancer exercises very very very very very very very very perfectly .	the dancer was very very very very very very very very perfectly .
the child reads very very very very very very very very very very quickly .	the child was very very very very very very very very very very quickly .
the boy reads very very very very very very very quickly .	the boy was very very very very very very very quickly .
the guy paints very very very very very very very very very perfectly .	the guy was very very very very very very very very very perfectly .
the adult cries very very very very very very very perfectly .	the adult was very very very very very very very perfectly .
the doctor cries really really really really really really really really really really perfectly .	the doctor was really really really really really really really really really really perfectly .
the queen paints really really really really really really really quietly .	the queen was really really really really really really really quietly .
the doctor paints really really really really really really really really really carefully .	the doctor was really really really really really really really really really carefully .
the teacher sings very very very very very very very very carefully .	the teacher was very very very very very very very very carefully .
the patient waves very very very very very very very quietly .	the patient was very very very very very very very quietly .
the dancer reads really really really really really really really carefully .	the dancer was really really really really really really really carefully .
the patient reads very very very very very very very very very very perfectly .	the patient is very very very very very very very very very very perfectly .
the child talks very very very very very very very perfectly .	the child was very very very very very very very perfectly .
the queen paints very very very very very very very very very carefully .	the queen was very very very very very very very very very carefully .
the queen talks very very very very very very very very very perfectly .	the queen is very very very very very very very very very perfectly .
the guy paints really really really really really really really really really carefully .	the guy is really really really really really really really really really carefully .
the adult paints very very very very very very very very very very carefully .	the adult was very very very very very very very very very very carefully .
the boy cries very very very very very very very quickly .	the boy is very very very very very very very quickly .
the lady sings really really really really really really really quickly .	the lady was really really really really really really really quickly .
the patient talks very very very very very very very very very carefully .	the patient was very very very very very very very very very carefully .
the man talks really really really really really really really really really really carefully .	the man was really really really really really really really really really really carefully .
the driver sings really really really really really really really really carefully .	the driver is really really really really really really really really carefully .
the king reads very very very very very very very very very carefully .	the king is very very very very very very very very very carefully .
the patient talks very very very very very very very very very perfectly .	the patient is very very very very very very very very very perfectly .
the man cries very very very very very very very very very very quietly .	the man is very very very very very very very very very very quietly .
the child waves very very very very very very very very very quickly .	the child was very very very very very very very very very quickly .
the child cries very very very very very very very very perfectly .	the child was very very very very very very very very perfectly .
the adult paints really really really really really really really really really perfectly .	the adult is really really really really really really really really really perfectly .
the man sings very very very very very very very very very very slowly .	the man is very very very very very very very very very very slowly .
the man reads really really really really really really really really slowly .	the man is really really really really really really really really slowly .
the king exercises really really really really really really really really really really carefully .	the king is really really really really really really really really really really carefully .
the lady sings very very very very very very very very carefully .	the lady is very very very very very very very very carefully .
the dentist waves really really really really really really really really carefully .	the dentist was really really really really really really really really carefully .
the girl reads very very very very very very very carefully .	the girl was very very very very very very very carefully .
the girl talks really really really really really really really really really really carefully .	the girl is really really really really really really really really really really carefully .
the dancer paints really really really really really really really really slowly .	the dancer was really really really really really really really really slowly .
the doctor sings very very very very very very very slowly .	the doctor was very very very very very very very slowly .
the patient talks very very very very very very very very very very perfectly .	the patient was very very very very very very very very very very perfectly .
the dancer waves very very very very very very very very carefully .	the dancer is very very very very very very very very carefully .
the doctor sings really really really really really really really really quickly .	the doctor is really really really really really really really really quickly .
the queen paints very very very very very very very very very slowly .	the queen is very very very very very very very very very slowly .
the dancer exercises very very very very very very very very very very quickly .	the dancer was very very very very very very very very very very quickly .
the person sings very very very very very very very very very very quietly .	the person was very very very very very very very very very very quietly .
the teacher paints very very very very very very very slowly .	the teacher is very very very very very very very slowly .
the doctor paints really really really really really really really really really quickly .	the doctor was really really really really really really really really really quickly .
the person waves very very very very very very very very quickly .	the person was very very very very very very very very quickly .
the driver reads very very very very very very very very slowly .	the driver was very very very very very very very very slowly .
the king paints very very very very very very very very very quietly .	the king is very very very very very very very very very quietly .
the man talks very very very very very very very slowly .	the man is very very very very very very very slowly .
the guy talks very very very very very very very very carefully .	the guy is very very very very very very very very carefully .
the driver exercises really really really really really really really really really slowly .	the driver is really really really really really really really really really slowly .
the child exercises really really really really really really really slowly .	the child was really really really really really really really slowly .
the teacher exercises really really really really really really really really really really quietly .	the teacher is really really really really really really really really really really quietly .
the girl sings really really really really really really really really really perfectly .	the girl is really really really really really really really really really perfectly .
the queen exercises really really really really really really really really really really quietly .	the queen was really really really really really really really really really really quietly .
the boy talks very very very very very very very quietly .	the boy is very very very very very very very quietly .
the king sings really really really really really really really really really quickly .	the king is really really really really really really really really really quickly .
the customer paints really really really really really really really perfectly .	the customer is really really really really really really really perfectly .
the boy paints really really really really really really really really really really perfectly .	the boy was really really really really really really really really really really perfectly .
the boy exercises very very very very very very very perfectly .	the boy was very very very very very very very perfectly .
the teacher exercises really really really really really really really perfectly .	the teacher is really really really really really really really perfectly .
the child paints very very very very very very very very very perfectly .	the child was very very very very very very very very very perfectly .
the child waves really really really really really really really really really really quickly .	the child was really really really really really really really really really really quickly .
the patient cries really really really really really really really really really really slowly .	the patient was really really really really really really really really really really slowly .
the customer exercises very very very very very very very very very very perfectly .	the customer was very very very very very very very very very very perfectly .
the king waves very very very very very very very very very very quietly .	the king was very very very very very very very very very very quietly .
the woman reads really really really really really really really really really really quickly .	the woman is really really really really really really really really really really quickly .
the person waves really really really really really really really perfectly .	the person was really really really really really really really perfectly .
the lady paints very very very very very very very perfectly .	the lady was very very very very very very very perfectly .
the boy paints really really really really really really really really really really slowly .	the boy is really really really really really really really really really really slowly .
the child reads very very very very very very very very perfectly .	the child was very very very very very very very very perfectly .
the doctor exercises very very very very very very very quickly .	the doctor is very very very very very very very quickly .
the driver talks really really really really really really really really really carefully .	the driver was really really really really really really really really really carefully .
the man cries very very very very very very very carefully .	the man was very very very very very very very carefully .
the customer exercises very very very very very very very quietly .	the customer is very very very very very very very quietly .
the customer waves really really really really really really really really really quickly .	the customer was really really really really really really really really really quickly .
the queen waves very very very very very very very very very quickly .	the queen was very very very very very very very very very quickly .
the girl talks very very very very very very very very very very carefully .	the girl is very very very very very very very very very very carefully .
the customer talks very very very very very very very very slowly .	the customer is very very very very very very very very slowly .
the dentist paints very very very very very very very very very perfectly .	the dentist is very very very very very very very very very perfectly .
the woman paints very very very very very very very very slowly .	the woman is very very very very very very very very slowly .
the dancer paints really really really really really really really really really carefully .	the dancer is really really really really really really really really really carefully .
the dentist reads really really really really really really really really really slowly .	the dentist was really really really really really really really really really slowly .
the driver waves really really really really really really really quietly .	the driver is really really really really really really really quietly .
the doctor cries very very very very very very very very very very perfectly .	the doctor is very very very very very very very very very very perfectly .
the boy talks very very very very very very very quietly .	the boy was very very very very very very very quietly .
the customer reads very very very very very very very very very slowly .	the customer was very very very very very very very very very slowly .
the teacher exercises really really really really really really really carefully .	the teacher was really really really really really really really carefully .
the woman cries very very very very very very very very very very slowly .	the woman is very very very very very very very very very very slowly .
the lady talks very very very very very very very perfectly .	the lady is very very very very very very very perfectly .
the driver sings really really really really really really really quickly .	the driver was really really really really really really really quickly .
the girl paints really really really really really really really really quickly .	the girl is really really really really really really really really quickly .
the woman exercises really really really really really really really really really really carefully .	the woman is really really really really really really really really really really carefully .
the lady sings really really really really really really really really really really carefully .	the lady was really really really really really really really really really really carefully .
the customer waves really really really really really really really slowly .	the customer is really really really really really really really slowly .
the girl cries really really really really really really really really really slowly .	the girl was really really really really really really really really really slowly .
the king talks very very very very very very very perfectly .	the king was very very very very very very very perfectly .
the king cries very very very very very very very very very very quickly .	the king was very very very very very very very very very very quickly .
the dancer sings very very very very very very very carefully .	the dancer is very very very very very very very carefully .
the dancer talks very very very very very very very very carefully .	the dancer is very very very very very very very very carefully .
the child waves very very very very very very very very very perfectly .	the child was very very very very very very very very very perfectly .
the lady paints very very very very very very very very very very slowly .	the lady is very very very very very very very very very very slowly .
the adult paints very very very very very very very very carefully .	the adult is very very very very very very very very carefully .
the dentist cries really really really really really really really really really really perfectly .	the dentist is really really really really really really really really really really perfectly .
the child cries really really really really really really really really really perfectly .	the child was really really really really really really really really really perfectly .
the lady reads really really really really really really really really really really carefully .	the lady is really really really really really really really really really really carefully .
the child reads very very very very very very very very very very perfectly .	the child is very very very very very very very very very very perfectly .
the king talks really really really really really really really really carefully .	the king is really really really really really really really really carefully .
the adult cries really really really really really really really really quietly .	the adult was really really really really really really really really quietly .
the boy cries really really really really really really really really really quickly .	the boy was really really really really really really really really really quickly .
the teacher exercises very very very very very very very very quietly .	the teacher is very very very very very very very very quietly .
the adult talks really really really really really really really really really quickly .	the adult is really really really really really really really really really quickly .
the customer cries really really really really really really really really quietly .	the customer was really really really really really really really really quietly .
the person reads very very very very very very very very slowly .	the person was very very very very very very very very slowly .
the adult waves very very very very very very very very very slowly .	the adult is very very very very very very very very very slowly .
the patient paints really really really really really really really really perfectly .	the patient was really really really really really really really really perfectly .
the man reads very very very very very very very very very quietly .	the man was very very very very very very very very very quietly .
the adult exercises really really really really really really really perfectly .	the adult is really really really really really really really perfectly .
the guy paints really really really really really really really really really really slowly .	the guy was really really really really really really really really really really slowly .
the dancer sings very very very very very very very slowly .	the dancer was very very very very very very very slowly .
the lady cries really really really really really really really really perfectly .	the lady is really really really really really really really really perfectly .
the child cries really really really really really really really really really really slowly .	the child is really really really really really really really really really really slowly .
the guy reads really really really really really really really really really really carefully .	the guy is really really really really really really really really really really carefully .
the king waves very very very very very very very very very very quickly .	the king was very very very very very very very very very very quickly .
the teacher talks very very very very very very very very very very slowly .	the teacher is very very very very very very very very very very slowly .
the king waves really really really really really really really really slowly .	the king was really really really really really really really really slowly .
the dentist talks really really really really really really really really really really carefully .	the dentist was really really really really really really really really really really carefully .
the queen talks really really really really really really really really really carefully .	the queen is really really really really really really really really really carefully .
the person paints really really really really really really really really quietly .	the person was really really really really really really really really quietly .
the king waves really really really really really really really really quietly .	the king was really really really really really really really really quietly .
the man sings really really really really really really really perfectly .	the man was really really really really really really really perfectly .
the dancer exercises very very very very very very very very very carefully .	the dancer was very very very very very very very very very carefully .
the boy waves very very very very very very very very very very slowly .	the boy is very very very very very very very very very very slowly .
the person sings really really really really really really really really perfectly .	the person was really really really really really really really really perfectly .
the dancer talks very very very very very very very very very very carefully .	the dancer was very very very very very very very very very very carefully .
the girl talks really really really really really really really really quietly .	the girl was really really really really really really really really quietly .
the woman exercises really really really really really really really really quietly .	the woman is really really really really really really really really quietly .
the dentist paints very very very very very very very very very carefully .	the dentist is very very very very very very very very very carefully .
the dancer waves really really really really really really really really really quietly .	the dancer is really really really really really really really really really quietly .
the dancer waves really really really really really really really slowly .	the dancer is really really really really really really really slowly .
the man paints really really really really really really really really really slowly .	the man is really really really really really really really really really slowly .
the guy exercises very very very very very very very very very slowly .	the guy was very very very very very very very very very slowly .
the customer waves really really really really really really really really really quietly .	the customer is really really really really really really really really really quietly .
the guy waves very very very very very very very quietly .	the guy was very very very very very very very quietly .
the queen reads really really really really really really really quietly .	the queen was really really really really really really really quietly .
the person reads really really really really really really really really perfectly .	the person was really really really really really really really really perfectly .
the driver talks really really really really really really really really quietly .	the driver is really really really really really really really really quietly .
the girl sings really really really really really really really really quickly .	the girl was really really really really really really really really quickly .
the boy reads really really really really really really really really quietly .	the boy is really really really really really really really really quietly .
the child cries very very very very very very very perfectly .	the child was very very very very very very very perfectly .
the adult talks very very very very very very very very very very slowly .	the adult was very very very very very very very very very very slowly .
the person paints very very very very very very very very very perfectly .	the person is very very very very very very very very very perfectly .
the lady talks very very very very very very very very very very quickly .	the lady is very very very very very very very very very very quickly .
the teacher exercises very very very very very very very very very very quietly .	the teacher is very very very very very very very very very very quietly .
the queen sings really really really really really really really really really really perfectly .	the queen is really really really really really really really really really really perfectly .
the boy paints very very very very very very very very very very perfectly .	the boy is very very very very very very very very very very perfectly .
the person reads very very very very very very very very very quickly .	the person was very very very very very very very very very quickly .
the driver talks really really really really really really really carefully .	the driver is really really really really really really really carefully .
the king waves really really really really really really really really really perfectly .	the king was really really really really really really really really really perfectly .
the guy exercises really really really really really really really slowly .	the guy is really really really really really really really slowly .
the girl cries very very very very very very very very slowly .	the girl is very very very very very very very very slowly .
the man sings very very very very very very very very very very quickly .	the man is very very very very very very very very very very quickly .
the child exercises very very very very very very very quickly .	the child was very very very very very very very quickly .
the adult sings very very very very very very very quickly .	the adult was very very very very very very very quickly .
the child paints very very very very very very very very slowly .	the child is very very very very very very very very slowly .
the person reads very very very very very very very carefully .	the person is very very very very very very very carefully .
the person sings really really really really really really really really carefully .	the person is really really really really really really really really carefully .
the teacher sings really really really really really really really quietly .	the teacher is really really really really really really really quietly .
the boy paints very very very very very very very very very very quietly .	the boy is very very very very very very very very very very quietly .
the dentist paints really really really really really really really really really quietly .	the dentist is really really really really really really really really really quietly .
the child sings very very very very very very very very carefully .	the child was very very very very very very very very carefully .
the dancer paints really really really really really really really really really quietly .	the dancer was really really really really really really really really really quietly .
the teacher sings really really really really really really really perfectly .	the teacher is really really really really really really really perfectly .
the doctor talks really really really really really really really perfectly .	the doctor was really really really really really really really perfectly .
the dancer waves very very very very very very very very very very perfectly .	the dancer is very very very very very very very very very very perfectly .
the patient exercises very very very very very very very carefully .	the patient is very very very very very very very carefully .
the queen reads very very very very very very very very perfectly .	the queen was very very very very very very very very perfectly .
the customer paints very very very very very very very very very carefully .	the customer is very very very very very very very very very carefully .
the adult waves very very very very very very very very very very slowly .	the adult is very very very very very very very very very very slowly .
the man waves very very very very very very very very very slowly .	the man was very very very very very very very very very slowly .
the driver talks really really really really really really really quietly .	the driver was really really really really really really really quietly .
the adult exercises very very very very very very very very very very carefully .	the adult is very very very very very very very very very very carefully .
the patient talks really really really really really really really really really quickly .	the patient is really really really really really really really really really quickly .
the driver exercises very very very very very very very very very carefully .	the driver was very very very very very very very very very carefully .
the driver reads very very very very very very very very perfectly .	the driver is very very very very very very very very perfectly .
the guy paints very very very very very very very very very slowly .	the guy is very very very very very very very very very slowly .
the lady cries very very very very very very very very carefully .	the lady is very very very very very very very very carefully .
the doctor talks really really really really really really really carefully .	the doctor was really really really really really really really carefully .
the adult paints very very very very very very very very very very carefully .	the adult is very very very very very very very very very very carefully .
the patient reads really really really really really really really perfectly .	the patient was really really really really really really really perfectly .
the boy talks really really really really really really really really perfectly .	the boy was really really really really really really really really perfectly .
the boy paints really really really really really really really carefully .	the boy is really really really really really really really carefully .
the man sings really really really really really really really really really really perfectly .	the man was really really really really really really really really really really perfectly .
the guy waves very very very very very very very very slowly .	the guy was very very very very very very very very slowly .
the customer reads very very very very very very very very very quickly .	the customer was very very very very very very very very very quickly .
the guy waves very very very very very very very very slowly .	the guy is very very very very very very very very slowly .
the patient paints really really really really really really really perfectly .	the patient was really really really really really really really perfectly .
the lady talks very very very very very very very very very very carefully .	the lady is very very very very very very very very very very carefully .
the teacher reads very very very very very very very very very quickly .	the teacher was very very very very very very very very very quickly .
the boy exercises really really really really really really really quickly .	the boy was really really really really really really really quickly .
the girl sings very very very very very very very slowly .	the girl is very very very very very very very slowly .
the child reads really really really really really really really really perfectly .	the child is really really really really really really really really perfectly .
the king cries really really really really really really really quietly .	the king is really really really really really really really quietly .
the adult sings really really really really really really really slowly .	the adult was really really really really really really really slowly .
the lady cries very very very very very very very quickly .	the lady was very very very very very very very quickly .
the man waves really really really really really really really really really perfectly .	the man is really really really really really really really really really perfectly .
the king talks really really really really really really really really really quietly .	the king is really really really really really really really really really quietly .
the boy reads really really really really really really really slowly .	the boy is really really really really really really really slowly .
the patient exercises really really really really really really really really really slowly .	the patient is really really really really really really really really really slowly .
the adult exercises really really really really really really really quickly .	the adult was really really really really really really really quickly .
the lady reads very very very very very very very very very quickly .	the lady was very very very very very very very very very quickly .
the teacher waves very very very very very very very very very very quietly .	the teacher is very very very very very very very very very very quietly .
the woman exercises very very very very very very very very very slowly .	the woman is very very very very very very very very very slowly .
the patient exercises very very very very very very very very very carefully .	the patient is very very very very very very very very very carefully .
the adult waves really really really really really really really carefully .	the adult was really really really really really really really carefully .
the man sings very very very very very very very very very quickly .	the man was very very very very very very very very very quickly .
the child sings really really really really really really really really really perfectly .	the child is really really really really really really really really really perfectly .
the teacher sings very very very very very very very very very quickly .	the teacher was very very very very very very very very very quickly .
the queen sings very very very very very very very very very very quickly .	the queen is very very very very very very very very very very quickly .
the queen cries very very very very very very very carefully .	the queen is very very very very very very very carefully .
the driver talks very very very very very very very very very perfectly .	the driver is very very very very very very very very very perfectly .
the adult reads very very very very very very very very carefully .	the adult was very very very very very very very very carefully .
the dancer reads really really really really really really really really really quickly .	the dancer was really really really really really really really really really quickly .
the woman waves very very very very very very very carefully .	the woman was very very very very very very very carefully .
the customer talks really really really really really really really really really really perfectly .	the customer is really really really really really really really really really really perfectly .
the teacher sings very very very very very very very very very slowly .	the teacher was very very very very very very very very very slowly .
the dancer waves really really really really really really really really quickly .	the dancer is really really really really really really really really quickly .
the man exercises very very very very very very very very very quietly .	the man is very very very very very very very very very quietly .
the adult reads really really really really really really really really really slowly .	the adult was really really really really really really really really really slowly .
the lady sings very very very very very very very slowly .	the lady was very very very very very very very slowly .
the lady reads really really really really really really really really really carefully .	the lady is really really really really really really really really really carefully .
the man waves really really really really really really really really really quietly .	the man is really really really really really really really really really quietly .
the girl paints really really really really really really really really really quickly .	the girl was really really really really really really really really really quickly .
the dancer paints really really really really really really really perfectly .	the dancer is really really really really really really really perfectly .
the king exercises really really really really really really really really really perfectly .	the king was really really really really really really really really really perfectly .
the child waves very very very very very very very very perfectly .	the child is very very very very very very very very perfectly .
the dentist cries very very very very very very very very very quickly .	the dentist is very very very very very very very very very quickly .
the boy exercises really really really really really really really really really really perfectly .	the boy was really really really really really really really really really really perfectly .
the dentist paints really really really really really really really really slowly .	the dentist is really really really really really really really really slowly .
the child talks very very very very very very very very very very quickly .	the child was very very very very very very very very very very quickly .
the woman talks really really really really really really really really really really perfectly .	the woman is really really really really really really really really really really perfectly .
the woman reads very very very very very very very very very slowly .	the woman was very very very very very very very very very slowly .
the adult sings really really really really really really really really really really quickly .	the adult is really really really really really really really really really really quickly .
the adult sings really really really really really really really really really really slowly .	the adult is really really really really really really really really really really slowly .
the man cries very very very very very very very very very quickly .	the man was very very very very very very very very very quickly .
the doctor talks very very very very very very very very slowly .	the doctor was very very very very very very very very slowly .
the dentist sings really really really really really really really really really really quickly .	the dentist is really really really really really really really really really really quickly .
the adult sings really really really really really really really really really quickly .	the adult is really really really really really really really really really quickly .
the person waves really really really really really really really perfectly .	the person is really really really really really really really perfectly .
the dancer waves really really really really really really really really really really carefully .	the dancer is really really really really really really really really really really carefully .
the teacher cries really really really really really really really really really quickly .	the teacher is really really really really really really really really really quickly .
the child reads very very very very very very very very very very quietly .	the child is very very very very very very very very very very quietly .
the lady paints really really really really really really really quickly .	the lady was really really really really really really really quickly .
the boy talks really really really really really really really carefully .	the boy was really really really really really really really carefully .
the adult waves very very very very very very very perfectly .	the adult was very very very very very very very perfectly .
the patient waves very very very very very very very very carefully .	the patient was very very very very very very very very carefully .
the customer sings really really really really really really really quickly .	the customer is really really really really really really really quickly .
the king reads really really really really really really really slowly .	the king is really really really really really really really slowly .
the customer exercises very very very very very very very very very very quietly .	the customer is very very very very very very very very very very quietly .
the man exercises very very very very very very very very very very quickly .	the man is very very very very very very very very very very quickly .
the adult paints really really really really really really really really really slowly .	the adult was really really really really really really really really really slowly .
the guy exercises very very very very very very very very very quietly .	the guy was very very very very very very very very very quietly .
the queen cries really really really really really really really quickly .	the queen was really really really really really really really quickly .
the teacher reads really really really really really really really really really quietly .	the teacher is really really really really really really really really really quietly .
the king cries really really really really really really really really slowly .	the king is really really really really really really really really slowly .
the dancer talks really really really really really really really slowly .	the dancer is really really really really really really really slowly .
the girl reads very very very very very very very very very quickly .	the girl was very very very very very very very very very quickly .
the woman sings very very very very very very very slowly .	the woman was very very very very very very very slowly .
the woman sings really really really really really really really slowly .	the woman is really really really really really really really slowly .
the patient talks very very very very very very very carefully .	the patient is very very very very very very very carefully .
the queen cries very very very very very very very very quietly .	the queen is very very very very very very very very quietly .
the child sings really really really really really really really quickly .	the child is really really really really really really really quickly .
the girl reads really really really really really really really really really really slowly .	the girl is really really really really really really really really really really slowly .
the guy cries very very very very very very very very very very perfectly .	the guy was very very very very very very very very very very perfectly .
the queen reads really really really really really really really perfectly .	the queen was really really really really really really really perfectly .
the dentist paints very very very very very very very very very slowly .	the dentist was very very very very very very very very very slowly .
the teacher paints really really really really really really really really really quietly .	the teacher was really really really really really really really really really quietly .
the customer talks very very very very very very very very quietly .	the customer was very very very very very very very very quietly .
the patient exercises very very very very very very very very very perfectly .	the patient was very very very very very very very very very perfectly .
the lady talks very very very very very very very slowly .	the lady was very very very very very very very slowly .
the dentist paints really really really really really really really quickly .	the dentist is really really really really really really really quickly .
the dentist reads very very very very very very very quietly .	the dentist was very very very very very very very quietly .
the person reads really really really really really really really really really really quietly .	the person is really really really really really really really really really really quietly .
the man waves really really really really really really really really really slowly .	the man is really really really really really really really really really slowly .
the girl sings really really really really really really really slowly .	the girl was really really really really really really really slowly .
the dentist sings really really really really really really really quietly .	the dentist was really really really really really really really quietly .
the driver cries very very very very very very very very very quietly .	the driver is very very very very very very very very very quietly .
the adult reads really really really really really really really really really quickly .	the adult is really really really really really really really really really quickly .
the patient waves really really really really really really really really perfectly .	the patient is really really really really really really really really perfectly .
the doctor cries really really really really really really really really really slowly .	the doctor was really really really really really really really really really slowly .
the boy talks really really really really really really really quietly .	the boy was really really really really really really really quietly .
the queen talks really really really really really really really carefully .	the queen was really really really really really really really carefully .
the guy waves really really really really really really really really really quietly .	the guy is really really really really really really really really really quietly .
the person talks very very very very very very very very very quickly .	the person was very very very very very very very very very quickly .
the man cries really really really really really really really really really carefully .	the man is really really really really really really really really really carefully .
the guy reads really really really really really really really really really really quickly .	the guy is really really really really really really really really really really quickly .
the man cries very very very very very very very carefully .	the man is very very very very very very very carefully .
the doctor talks very very very very very very very very very carefully .	the doctor was very very very very very very very very very carefully .
the dancer exercises really really really really really really really really really really perfectly .	the dancer was really really really really really really really really really really perfectly .
the person waves really really really really really really really really really really quietly .	the person is really really really really really really really really really really quietly .
the king paints very very very very very very very very quietly .	the king was very very very very very very very very quietly .
the customer sings very very very very very very very carefully .	the customer is very very very very very very very carefully .
the teacher reads really really really really really really really really really really carefully .	the teacher is really really really really really really really really really really carefully .
the woman talks very very very very very very very quickly .	the woman is very very very very very very very quickly .
the doctor sings very very very very very very very very quickly .	the doctor was very very very very very very very very quickly .
the woman talks really really really really really really really quickly .	the woman was really really really really really really really quickly .
the lady waves very very very very very very very quickly .	the lady is very very very very very very very quickly .
the woman reads really really really really really really really really really really carefully .	the woman was really really really really really really really really really really carefully .
the lady sings really really really really really really really quietly .	the lady was really really really really really really really quietly .
the lady exercises really really really really really really really really quickly .	the lady was really really really really really really really really quickly .
the child cries very very very very very very very very quietly .	the child was very very very very very very very very quietly .
the patient exercises very very very very very very very perfectly .	the patient was very very very very very very very perfectly .
the driver paints very very very very very very very very quickly .	the driver was very very very very very very very very quickly .
the adult talks really really really really really really really quietly .	the adult is really really really really really really really quietly .
the dentist sings really really really really really really really really really really slowly .	the dentist is really really really really really really really really really really slowly .
the lady sings very very very very very very very perfectly .	the lady was very very very very very very very perfectly .
the dancer cries very very very very very very very very carefully .	the dancer was very very very very very very very very carefully .
the driver waves very very very very very very very perfectly .	the driver is very very very very very very very perfectly .
the girl talks really really really really really really really quickly .	the girl was really really really really really really really quickly .
the queen sings very very very very very very very slowly .	the queen was very very very very very very very slowly .
the adult sings very very very very very very very very very carefully .	the adult is very very very very very very very very very carefully .
the dancer exercises really really really really really really really perfectly .	the dancer was really really really really really really really perfectly .
the guy waves really really really really really really really really quietly .	the guy was really really really really really really really really quietly .
the guy talks very very very very very very very quietly .	the guy is very very very very very very very quietly .
the woman sings very very very very very very very quietly .	the woman is very very very very very very very quietly .
the customer cries really really really really really really really perfectly .	the customer is really really really really really really really perfectly .
the guy reads really really really really really really really really really perfectly .	the guy is really really really really really really really really really perfectly .
the boy exercises very very very very very very very carefully .	the boy was very very very very very very very carefully .
the doctor exercises very very very very very very very very very perfectly .	the doctor was very very very very very very very very very perfectly .
the lady cries very very very very very very very very very quietly .	the lady was very very very very very very very very very quietly .
the driver sings really really really really really really really slowly .	the driver was really really really really really really really slowly .
the woman exercises really really really really really really really really really really perfectly .	the woman is really really really really really really really really really really perfectly .
the boy paints really really really really really really really really really perfectly .	the boy is really really really really really really really really really perfectly .
the driver reads really really really really really really really really really really slowly .	the driver was really really really really really really really really really really slowly .
the child cries very very very very very very very perfectly .	the child is very very very very very very very perfectly .
the guy paints very very very very very very very very very very quickly .	the guy is very very very very very very very very very very quickly .
the king exercises very very very very very very very very perfectly .	the king was very very very very very very very very perfectly .
the queen talks very very very very very very very very perfectly .	the queen was very very very very very very very very perfectly .
the customer exercises really really really really really really really really really carefully .	the customer is really really really really really really really really really carefully .
the person paints really really really really really really really really really slowly .	the person is really really really really really really really really really slowly .
the patient talks really really really really really really really really perfectly .	the patient was really really really really really really really really perfectly .
the boy talks really really really really really really really really really really quickly .	the boy was really really really really really really really really really really quickly .
the queen reads very very very very very very very very very very quietly .	the queen was very very very very very very very very very very quietly .
the teacher exercises really really really really really really really really really really quickly .	the teacher was really really really really really really really really really really quickly .
the woman talks very very very very very very very very very very carefully .	the woman is very very very very very very very very very very carefully .
the person reads very very very very very very very very very slowly .	the person is very very very very very very very very very slowly .
the lady waves very very very very very very very very very carefully .	the lady is very very very very very very very very very carefully .
the teacher exercises very very very very very very very perfectly .	the teacher was very very very very very very very perfectly .
the lady paints really really really really really really really really really really carefully .	the lady was really really really really really really really really really really carefully .
the dentist cries really really really really really really really quickly .	the dentist was really really really really really really really quickly .
the person talks very very very very very very very very perfectly .	the person is very very very very very very very very perfectly .
the customer reads really really really really really really really really quickly .	the customer was really really really really really really really really quickly .
the woman paints very very very very very very very very very quickly .	the woman was very very very very very very very very very quickly .
the girl sings really really really really really really really really really really quickly .	the girl was really really really really really really really really really really quickly .
the guy reads very very very very very very very very very carefully .	the guy was very very very very very very very very very carefully .
the boy waves really really really really really really really carefully .	the boy was really really really really really really really carefully .
the dentist reads very very very very very very very very very perfectly .	the dentist was very very very very very very very very very perfectly .
the child waves really really really really really really really really perfectly .	the child was really really really really really really really really perfectly .
the girl cries really really really really really really really really quickly .	the girl is really really really really really really really really quickly .
the adult reads really really really really really really really really really really slowly .	the adult is really really really really really really really really really really slowly .
the lady reads very very very very very very very very very very carefully .	the lady was very very very very very very very very very very carefully .
the dancer sings really really really really really really really really quickly .	the dancer is really really really really really really really really quickly .
the boy cries very very very very very very very very quietly .	the boy was very very very very very very very very quietly .
the lady waves very very very very very very very very very slowly .	the lady is very very very very very very very very very slowly .
the woman sings really really really really really really really really really carefully .	the woman was really really really really really really really really really carefully .
the king talks really really really really really really really really really quickly .	the king was really really really really really really really really really quickly .
the patient cries very very very very very very very very very very quietly .	the patient is very very very very very very very very very very quietly .
the king cries really really really really really really really really really slowly .	the king was really really really really really really really really really slowly .
the boy exercises very very very very very very very very very very perfectly .	the boy was very very very very very very very very very very perfectly .
the customer sings very very very very very very very slowly .	the customer was very very very very very very very slowly .
the woman sings very very very very very very very very very very quickly .	the woman was very very very very very very very very very very quickly .
the dancer sings very very very very very very very very very quickly .	the dancer was very very very very very very very very very quickly .
the child paints really really really really really really really carefully .	the child was really really really really really really really carefully .
the woman waves very very very very very very very perfectly .	the woman was very very very very very very very perfectly .
the boy waves very very very very very very very very very very perfectly .	the boy is very very very very very very very very very very perfectly .
the lady cries really really really really really really really really perfectly .	the lady was really really really really really really really really perfectly .
the customer cries very very very very very very very quietly .	the customer is very very very very very very very quietly .
the person sings really really really really really really really really really really slowly .	the person is really really really really really really really really really really slowly .
the boy sings very very very very very very very very very very slowly .	the boy was very very very very very very very very very very slowly .
the man paints really really really really really really really really really carefully .	the man is really really really really really really really really really carefully .
the king waves very very very very very very very quickly .	the king was very very very very very very very quickly .
the driver paints really really really really really really really really really really slowly .	the driver is really really really really really really really really really really slowly .
the customer paints very very very very very very very very perfectly .	the customer is very very very very very very very very perfectly .
the person waves very very very very very very very very slowly .	the person is very very very very very very very very slowly .
the doctor waves very very very very very very very very very very quickly .	the doctor is very very very very very very very very very very quickly .
the boy sings really really really really really really really really really really slowly .	the boy was really really really really really really really really really really slowly .
the man paints very very very very very very very very slowly .	the man was very very very very very very very very slowly .
the teacher talks very very very very very very very very very quickly .	the teacher is very very very very very very very very very quickly .
the doctor talks really really really really really really really really really quickly .	the doctor is really really really really really really really really really quickly .
the doctor talks very very very very very very very very very very quietly .	the doctor is very very very very very very very very very very quietly .
the dentist cries really really really really really really really really really quickly .	the dentist was really really really really really really really really really quickly .
the teacher sings very very very very very very very very very quietly .	the teacher is very very very very very very very very very quietly .
the king waves really really really really really really really really really quickly .	the king was really really really really really really really really really quickly .
the driver waves really really really really really really really really really slowly .	the driver was really really really really really really really really really slowly .
the dancer exercises very very very very very very very very very very slowly .	the dancer is very very very very very very very very very very slowly .
the driver exercises very very very very very very very very very very slowly .	the driver was very very very very very very very very very very slowly .
the guy reads really really really really really really really really quickly .	the guy is really really really really really really really really quickly .
the adult waves really really really really really really really really really carefully .	the adult was really really really really really really really really really carefully .
the girl waves very very very very very very very very carefully .	the girl is very very very very very very very very carefully .
the teacher cries very very very very very very very very quickly .	the teacher is very very very very very very very very quickly .
the king cries very very very very very very very quietly .	the king is very very very very very very very quietly .
the dentist talks really really really really really really really really really quietly .	the dentist is really really really really really really really really really quietly .
the customer exercises very very very very very very very very quickly .	the customer was very very very very very very very very quickly .
the queen reads very very very very very very very carefully .	the queen is very very very very very very very carefully .
the lady exercises really really really really really really really really really quickly .	the lady was really really really really really really really really really quickly .
the dentist waves very very very very very very very very carefully .	the dentist was very very very very very very very very carefully .
the queen reads really really really really really really really really really quietly .	the queen was really really really really really really really really really quietly .
the dentist waves very very very very very very very slowly .	the dentist was very very very very very very very slowly .
the girl reads very very very very very very very very very very quietly .	the girl was very very very very very very very very very very quietly .
the dentist talks really really really really really really really really quickly .	the dentist was really really really really really really really really quickly .
the woman exercises very very very very very very very very very quickly .	the woman is very very very very very very very very very quickly .
the dentist exercises really really really really really really really really really quietly .	the dentist is really really really really really really really really really quietly .
the dentist paints very very very very very very very very very very perfectly .	the dentist was very very very very very very very very very very perfectly .
the king waves really really really really really really really really really really quickly .	the king was really really really really really really really really really really quickly .
the dentist exercises really really really really really really really really really really quickly .	the dentist was really really really really really really really really really really quickly .
the queen waves really really really really really really really really quickly .	the queen was really really really really really really really really quickly .
the girl reads really really really really really really really quietly .	the girl was really really really really really really really quietly .
the boy talks very very very very very very very very quickly .	the boy was very very very very very very very very quickly .
the girl sings very very very very very very very very very carefully .	the girl was very very very very very very very very very carefully .
the dentist sings really really really really really really really really slowly .	the dentist is really really really really really really really really slowly .
the dentist paints very very very very very very very very very quietly .	the dentist is very very very very very very very very very quietly .
the child waves very very very very very very very very very very slowly .	the child was very very very very very very very very very very slowly .
the king paints very very very very very very very very very quickly .	the king was very very very very very very very very very quickly .
the adult exercises really really really really really really really slowly .	the adult is really really really really really really really slowly .
the doctor exercises very very very very very very very very very very carefully .	the doctor was very very very very very very very very very very carefully .
the woman reads really really really really really really really really slowly .	the woman is really really really really really really really really slowly .
the customer talks really really really really really really really really really really quietly .	the customer is really really really really really really really really really really quietly .
the child talks really really really really really really really quickly .	the child is really really really really really really really quickly .
the customer exercises very very very very very very very slowly .	the customer is very very very very very very very slowly .
the dancer exercises really really really really really really really really quietly .	the dancer was really really really really really really really really quietly .
the guy sings very very very very very very very perfectly .	the guy is very very very very very very very perfectly .
the dancer talks really really really really really really really really really carefully .	the dancer was really really really really really really really really really carefully .
the man sings really really really really really really really really really really quickly .	the man was really really really really really really really really really really quickly .
the driver exercises really really really really really really really really quietly .	the driver is really really really really really really really really quietly .
the patient paints really really really really really really really really slowly .	the patient is really really really really really really really really slowly .
the woman cries very very very very very very very very quickly .	the woman is very very very very very very very very quickly .
the queen talks really really really really really really really really really really quickly .	the queen was really really really really really really really really really really quickly .
the girl talks very very very very very very very perfectly .	the girl was very very very very very very very perfectly .
the customer cries really really really really really really really quietly .	the customer is really really really really really really really quietly .
the lady paints really really really really really really really really really perfectly .	the lady was really really really really really really really really really perfectly .
the man sings very very very very very very very very very very slowly .	the man was very very very very very very very very very very slowly .
the driver reads very very very very very very very very quietly .	the driver is very very very very very very very very quietly .
the adult waves very very very very very very very very very very perfectly .	the adult was very very very very very very very very very very perfectly .
the patient reads really really really really really really really really really carefully .	the patient is really really really really really really really really really carefully .
the patient reads really really really really really really really really really carefully .	the patient was really really really really really really really really really carefully .
the doctor paints really really really really really really really really really quietly .	the doctor is really really really really really really really really really quietly .
the driver exercises really really really really really really really really quickly .	the driver is really really really really really really really really quickly .
the driver exercises really really really really really really really carefully .	the driver was really really really really really really really carefully .
the doctor waves very very very very very very very very very very perfectly .	the doctor is very very very very very very very very very very perfectly .
the patient reads really really really really really really really really really perfectly .	the patient is really really really really really really really really really perfectly .
the teacher exercises very very very very very very very slowly .	the teacher was very very very very very very very slowly .
the dancer sings really really really really really really really really really carefully .	the dancer is really really really really really really really really really carefully .
the woman talks very very very very very very very very quickly .	the woman is very very very very very very very very quickly .
the person sings really really really really really really really carefully .	the person was really really really really really really really carefully .
the teacher waves really really really really really really really really quietly .	the teacher was really really really really really really really really quietly .
the girl talks really really really really really really really perfectly .	the girl is really really really really really really really perfectly .
the guy talks really really really really really really really really really slowly .	the guy was really really really really really really really really really slowly .
the patient talks very very very very very very very very perfectly .	the patient is very very very very very very very very perfectly .
the lady sings very very very very very very very very slowly .	the lady is very very very very very very very very slowly .
the woman exercises really really really really really really really really really really quickly .	the woman was really really really really really really really really really really quickly .
the girl exercises really really really really really really really really really really quietly .	the girl is really really really really really really really really really really quietly .
the girl sings very very very very very very very very very slowly .	the girl is very very very very very very very very very slowly .
the teacher waves really really really really really really really quickly .	the teacher was really really really really really really really quickly .
the dancer talks really really really really really really really slowly .	the dancer was really really really really really really really slowly .
the girl exercises very very very very very very very very very very slowly .	the girl is very very very very very very very very very very slowly .
the dentist reads very very very very very very very very quietly .	the dentist was very very very very very very very very quietly .
the lady cries very very very very very very very very very very perfectly .	the lady was very very very very very very very very very very perfectly .
the customer talks very very very very very very very very very slowly .	the customer is very very very very very very very very very slowly .
the child reads very very very very very very very very very very slowly .	the child was very very very very very very very very very very slowly .
the child cries really really really really really really really really really really carefully .	the child is really really really really really really really really really really carefully .
the doctor sings very very very very very very very slowly .	the doctor is very very very very very very very slowly .
the adult sings very very very very very very very quietly .	the adult is very very very very very very very quietly .
the customer paints very very very very very very very very slowly .	the customer was very very very very very very very very slowly .
the patient reads very very very very very very very very very very quietly .	the patient was very very very very very very very very very very quietly .
the doctor sings very very very very very very very very quietly .	the doctor was very very very very very very very very quietly .
the patient exercises really really really really really really really really really really carefully .	the patient is really really really really really really really really really really carefully .
the customer waves very very very very very very very very very quickly .	the customer is very very very very very very very very very quickly .
the guy paints very very very very very very very very slowly .	the guy is very very very very very very very very slowly .
the child talks really really really really really really really really really really carefully .	the child is really really really really really really really really really really carefully .
the guy reads really really really really really really really really really slowly .	the guy is really really really really really really really really really slowly .
the child cries very very very very very very very very carefully .	the child was very very very very very very very very carefully .
the person exercises very very very very very very very very quickly .	the person was very very very very very very very very quickly .
the queen cries very very very very very very very very quickly .	the queen was very very very very very very very very quickly .
the dentist reads very very very very very very very slowly .	the dentist was very very very very very very very slowly .
the dentist exercises very very very very very very very very very very perfectly .	the dentist was very very very very very very very very very very perfectly .
the person cries really really really really really really really really perfectly .	the person is really really really really really really really really perfectly .
the guy paints very very very very very very very very very perfectly .	the guy is very very very very very very very very very perfectly .
the customer cries very very very very very very very very very quickly .	the customer was very very very very very very very very very quickly .
the lady exercises really really really really really really really really really really quickly .	the lady was really really really really really really really really really really quickly .
the man talks very very very very very very very perfectly .	the man was very very very very very very very perfectly .
the man paints really really really really really really really quickly .	the man was really really really really really really really quickly .
the girl sings very very very very very very very very very very carefully .	the girl was very very very very very very very very very very carefully .
the person cries very very very very very very very very very very perfectly .	the person is very very very very very very very very very very perfectly .
the dentist talks really really really really really really really really really slowly .	the dentist was really really really really really really really really really slowly .
the adult cries really really really really really really really really really really carefully .	the adult was really really really really really really really really really really carefully .
the woman paints very very very very very very very very carefully .	the woman is very very very very very very very very carefully .
the dentist paints very very very very very very very very quickly .	the dentist is very very very very very very very very quickly .
the guy cries very very very very very very very very very very quietly .	the guy was very very very very very very very very very very quietly .
the queen paints really really really really really really really really quickly .	the queen is really really really really really really really really quickly .
the dentist talks very very very very very very very very quietly .	the dentist was very very very very very very very very quietly .
the patient reads really really really really really really really really quietly .	the patient is really really really really really really really really quietly .
the adult cries really really really really really really really really really quietly .	the adult is really really really really really really really really really quietly .
the lady paints really really really really really really really really carefully .	the lady was really really really really really really really really carefully .
the lady talks very very very very very very very very very quickly .	the lady is very very very very very very very very very quickly .
the queen cries very very very very very very very quietly .	the queen is very very very very very very very quietly .
the guy paints very very very very very very very very carefully .	the guy is very very very very very very very very carefully .
the man waves very very very very very very very very quietly .	the man is very very very very very very very very quietly .
the dentist cries very very very very very very very very very very carefully .	the dentist was very very very very very very very very very very carefully .
the man waves very very very very very very very carefully .	the man is very very very very very very very carefully .
the woman paints very very very very very very very very very carefully .	the woman is very very very very very very very very very carefully .
the queen talks really really really really really really really quietly .	the queen is really really really really really really really quietly .
the teacher paints really really really really really really really perfectly .	the teacher is really really really really really really really perfectly .
the guy cries really really really really really really really quietly .	the guy is really really really really really really really quietly .
the man waves very very very very very very very very very very carefully .	the man is very very very very very very very very very very carefully .
the dentist waves really really really really really really really really really really carefully .	the dentist is really really really really really really really really really really carefully .
the woman reads really really really really really really really really really really slowly .	the woman was really really really really really really really really really really slowly .
the child exercises really really really really really really really quickly .	the child is really really really really really really really quickly .
the child reads really really really really really really really carefully .	the child is really really really really really really really carefully .
the patient paints really really really really really really really really really quickly .	the patient is really really really really really really really really really quickly .
the woman reads very very very very very very very very quietly .	the woman was very very very very very very very very quietly .
the doctor cries very very very very very very very very very very quickly .	the doctor was very very very very very very very very very very quickly .
the doctor reads very very very very very very very very very perfectly .	the doctor is very very very very very very very very very perfectly .
the dentist sings really really really really really really really really really quickly .	the dentist was really really really really really really really really really quickly .
the adult cries really really really really really really really really slowly .	the adult is really really really really really really really really slowly .
the person talks very very very very very very very very very very carefully .	the person is very very very very very very very very very very carefully .
the person waves really really really really really really really carefully .	the person was really really really really really really really carefully .
the guy reads very very very very very very very very perfectly .	the guy is very very very very very very very very perfectly .
the child paints really really really really really really really quietly .	the child was really really really really really really really quietly .
the dentist talks very very very very very very very very very very carefully .	the dentist is very very very very very very very very very very carefully .
the woman paints very very very very very very very very quickly .	the woman was very very very very very very very very quickly .
the teacher talks very very very very very very very very very quietly .	the teacher was very very very very very very very very very quietly .
the patient cries really really really really really really really perfectly .	the patient was really really really really really really really perfectly .
the doctor reads really really really really really really really really really really quickly .	the doctor is really really really really really really really really really really quickly .
the man reads very very very very very very very very very very slowly .	the man is very very very very very very very very very very slowly .
the dancer sings very very very very very very very slowly .	the dancer is very very very very very very very slowly .
the dentist reads really really really really really really really really really perfectly .	the dentist is really really really really really really really really really perfectly .
the woman sings really really really really really really really really really really slowly .	the woman is really really really really really really really really really really slowly .
the dancer waves very very very very very very very very quietly .	the dancer is very very very very very very very very quietly .
the queen exercises very very very very very very very very very quickly .	the queen was very very very very very very very very very quickly .
the guy waves very very very very very very very very very perfectly .	the guy was very very very very very very very very very perfectly .
the man paints really really really really really really really really carefully .	the man is really really really really really really really really carefully .
the king waves really really really really really really really really perfectly .	the king is really really really really really really really really perfectly .
the patient reads very very very very very very very very very carefully .	the patient is very very very very very very very very very carefully .
the girl sings very very very very very very very very quietly .	the girl is very very very very very very very very quietly .
the dentist waves very very very very very very very quickly .	the dentist is very very very very very very very quickly .
the woman waves really really really really really really really quickly .	the woman is really really really really really really really quickly .
the girl paints really really really really really really really really carefully .	the girl is really really really really really really really really carefully .
the man cries very very very very very very very very slowly .	the man is very very very very very very very very slowly .
the lady reads really really really really really really really really really really slowly .	the lady was really really really really really really really really really really slowly .
the queen exercises really really really really really really really really really slowly .	the queen was really really really really really really really really really slowly .
the dancer reads really really really really really really really really really quickly .	the dancer is really really really really really really really really really quickly .
the doctor talks really really really really really really really really carefully .	the doctor was really really really really really really really really carefully .
the customer cries very very very very very very very very very very perfectly .	the customer is very very very very very very very very very very perfectly .
the guy talks really really really really really really really really really carefully .	the guy is really really really really really really really really really carefully .
the dancer waves really really really really really really really really really really quietly .	the dancer was really really really really really really really really really really quietly .
the king reads really really really really really really really perfectly .	the king was really really really really really really really perfectly .
the queen paints really really really really really really really really really really slowly .	the queen was really really really really really really really really really really slowly .
the customer cries really really really really really really really really really quickly .	the customer is really really really really really really really really really quickly .
the dancer paints very very very very very very very quietly .	the dancer was very very very very very very very quietly .
the adult exercises very very very very very very very very very quickly .	the adult was very very very very very very very very very quickly .
the driver exercises very very very very very very very carefully .	the driver was very very very very very very very carefully .
the doctor paints very very very very very very very perfectly .	the doctor is very very very very very very very perfectly .
the teacher reads very very very very very very very very very slowly .	the teacher is very very very very very very very very very slowly .
the person reads really really really really really really really quickly .	the person was really really really really really really really quickly .
the lady cries really really really really really really really carefully .	the lady is really really really really really really really carefully .
the child talks really really really really really really really really really quietly .	the child is really really really really really really really really really quietly .
the person exercises really really really really really really really really quietly .	the person was really really really really really really really really quietly .
the boy exercises really really really really really really really really really slowly .	the boy was really really really really really really really really really slowly .
the man cries really really really really really really really carefully .	the man is really really really really really really really carefully .
the child cries very very very very very very very very very very carefully .	the child is very very very very very very very very very very carefully .
the king reads very very very very very very very very carefully .	the king is very very very very very very very very carefully .
the guy exercises really really really really really really really really quietly .	the guy was really really really really really really really really quietly .
the dancer exercises really really really really really really really really really really quickly .	the dancer is really really really really really really really really really really quickly .
the teacher talks very very very very very very very very quickly .	the teacher is very very very very very very very very quickly .
the man cries very very very very very very very very very very slowly .	the man is very very very very very very very very very very slowly .
the guy talks very very very very very very very very very quietly .	the guy is very very very very very very very very very quietly .
the lady paints very very very very very very very quietly .	the lady was very very very very very very very quietly .
the child exercises really really really really really really really really quietly .	the child was really really really really really really really really quietly .
the king paints really really really really really really really really really really slowly .	the king was really really really really really really really really really really slowly .
the guy reads very very very very very very very very quickly .	the guy is very very very very very very very very quickly .
the king sings really really really really really really really really really really perfectly .	the king is really really really really really really really really really really perfectly .
the person exercises really really really really really really really carefully .	the person was really really really really really really really carefully .
the person paints really really really really really really really slowly .	the person was really really really really really really really slowly .
the guy talks really really really really really really really quietly .	the guy is really really really really really really really quietly .
the customer talks very very very very very very very very very very quietly .	the customer was very very very very very very very very very very quietly .
the dentist talks very very very very very very very very slowly .	the dentist was very very very very very very very very slowly .
the teacher paints really really really really really really really really quietly .	the teacher is really really really really really really really really quietly .
the king sings really really really really really really really quickly .	the king was really really really really really really really quickly .
the girl waves really really really really really really really really really really carefully .	the girl was really really really really really really really really really really carefully .
the doctor reads really really really really really really really really really really carefully .	the doctor was really really really really really really really really really really carefully .
the adult sings really really really really really really really really carefully .	the adult is really really really really really really really really carefully .
the driver reads very very very very very very very very quickly .	the driver was very very very very very very very very quickly .
the lady cries very very very very very very very very very very quietly .	the lady is very very very very very very very very very very quietly .
the king exercises very very very very very very very very slowly .	the king is very very very very very very very very slowly .
the adult waves very very very very very very very very quietly .	the adult was very very very very very very very very quietly .
the girl talks really really really really really really really really really carefully .	the girl was really really really really really really really really really carefully .
the doctor cries really really really really really really really really quietly .	the doctor is really really really really really really really really quietly .
the teacher waves very very very very very very very very slowly .	the teacher is very very very very very very very very slowly .
the girl cries very very very very very very very perfectly .	the girl was very very very very very very very perfectly .
the adult exercises really really really really really really really quickly .	the adult is really really really really really really really quickly .
the driver waves really really really really really really really really really quickly .	the driver is really really really really really really really really really quickly .
the woman paints very very very very very very very very very very quietly .	the woman is very very very very very very very very very very quietly .
the man waves really really really really really really really really really really quickly .	the man is really really really really really really really really really really quickly .
the boy reads really really really really really really really really really carefully .	the boy is really really really really really really really really really carefully .
the person cries really really really really really really really really really really carefully .	the person was really really really really really really really really really really carefully .
the boy waves really really really really really really really really quickly .	the boy was really really really really really really really really quickly .
the girl waves very very very very very very very very very very carefully .	the girl is very very very very very very very very very very carefully .
the teacher cries really really really really really really really really quickly .	the teacher was really really really really really really really really quickly .
the customer waves really really really really really really really really carefully .	the customer was really really really really really really really really carefully .
the man paints really really really really really really really really really quietly .	the man was really really really really really really really really really quietly .
the adult exercises really really really really really really really really really really slowly .	the adult is really really really really really really really really really really slowly .
the queen reads really really really really really really really really really quickly .	the queen is really really really really really really really really really quickly .
the driver sings very very very very very very very very slowly .	the driver was very very very very very very very very slowly .
the king waves really really really really really really really really really slowly .	the king is really really really really really really really really really slowly .
the driver reads very very very very very very very very perfectly .	the driver was very very very very very very very very perfectly .
the patient paints very very very very very very very very slowly .	the patient is very very very very very very very very slowly .
the child cries very very very very very very very very very quietly .	the child was very very very very very very very very very quietly .
the lady cries very very very very very very very quickly .	the lady is very very very very very very very quickly .
the teacher exercises really really really really really really really really perfectly .	the teacher is really really really really really really really really perfectly .
the person cries really really really really really really really really really really quickly .	the person is really really really really really really really really really really quickly .
the adult waves very very very very very very very quickly .	the adult was very very very very very very very quickly .
the driver exercises very very very very very very very very carefully .	the driver is very very very very very very very very carefully .
the customer sings very very very very very very very quietly .	the customer was very very very very very very very quietly .
the dentist waves really really really really really really really quietly .	the dentist was really really really really really really really quietly .
the child exercises really really really really really really really really really quietly .	the child was really really really really really really really really really quietly .
the man cries really really really really really really really quickly .	the man is really really really really really really really quickly .
the customer paints very very very very very very very very very very quietly .	the customer is very very very very very very very very very very quietly .
the customer cries really really really really really really really quietly .	the customer was really really really really really really really quietly .
the person exercises really really really really really really really really really quietly .	the person is really really really really really really really really really quietly .
the dancer paints very very very very very very very very slowly .	the dancer is very very very very very very very very slowly .
the king cries very very very very very very very very quietly .	the king is very very very very very very very very quietly .
the driver exercises really really really really really really really really carefully .	the driver is really really really really really really really really carefully .
the doctor talks very very very very very very very very carefully .	the doctor is very very very very very very very very carefully .
the queen exercises very very very very very very very very carefully .	the queen is very very very very very very very very carefully .
the customer paints really really really really really really really really quietly .	the customer is really really really really really really really really quietly .
the queen exercises really really really really really really really really slowly .	the queen is really really really really really really really really slowly .
the dancer reads very very very very very very very quickly .	the dancer was very very very very very very very quickly .
the woman reads really really really really really really really really quickly .	the woman was really really really really really really really really quickly .
the king waves very very very very very very very very slowly .	the king is very very very very very very very very slowly .
the customer sings really really really really really really really really slowly .	the customer was really really really really really really really really slowly .
the girl talks very very very very very very very very very slowly .	the girl is very very very very very very very very very slowly .
the girl reads really really really really really really really really really slowly .	the girl is really really really really really really really really really slowly .
the person sings very very very very very very very slowly .	the person is very very very very very very very slowly .
the patient paints really really really really really really really really quietly .	the patient was really really really really really really really really quietly .
the child paints very very very very very very very very perfectly .	the child was very very very very very very very very perfectly .
the customer reads very very very very very very very very very carefully .	the customer was very very very very very very very very very carefully .
the person sings really really really really really really really slowly .	the person was really really really really really really really slowly .
the customer sings very very very very very very very very very slowly .	the customer is very very very very very very very very very slowly .
the patient exercises really really really really really really really really carefully .	the patient is really really really really really really really really carefully .
the lady paints really really really really really really really really really really quickly .	the lady was really really really really really really really really really really quickly .
the patient paints really really really really really really really really really carefully .	the patient was really really really really really really really really really carefully .
the girl reads really really really really really really really really really perfectly .	the girl is really really really really really really really really really perfectly .
the customer reads very very very very very very very perfectly .	the customer was very very very very very very very perfectly .
the woman reads very very very very very very very perfectly .	the woman was very very very very very very very perfectly .
the child waves really really really really really really really perfectly .	the child was really really really really really really really perfectly .
the king exercises very very very very very very very quietly .	the king was very very very very very very very quietly .
the girl talks really really really really really really really really really carefully .	the girl is really really really really really really really really really carefully .
the king sings very very very very very very very very very very slowly .	the king was very very very very very very very very very very slowly .
the child cries really really really really really really really really slowly .	the child is really really really really really really really really slowly .
the person talks very very very very very very very very quickly .	the person is very very very very very very very very quickly .
the woman waves really really really really really really really really quickly .	the woman is really really really really really really really really quickly .
the man waves very very very very very very very very perfectly .	the man is very very very very very very very very perfectly .
the man reads very very very very very very very quietly .	the man is very very very very very very very quietly .
the guy reads very very very very very very very perfectly .	the guy was very very very very very very very perfectly .
the girl exercises really really really really really really really really quickly .	the girl was really really really really really really really really quickly .
the lady exercises really really really really really really really really carefully .	the lady is really really really really really really really really carefully .
the patient exercises very very very very very very very very perfectly .	the patient is very very very very very very very very perfectly .
the king talks really really really really really really really really really really slowly .	the king is really really really really really really really really really really slowly .
the woman waves really really really really really really really really really perfectly .	the woman was really really really really really really really really really perfectly .
the driver cries really really really really really really really slowly .	the driver was really really really really really really really slowly .
the child paints really really really really really really really really really slowly .	the child is really really really really really really really really really slowly .
the boy waves really really really really really really really slowly .	the boy was really really really really really really really slowly .
the teacher paints very very very very very very very very slowly .	the teacher is very very very very very very very very slowly .
the queen waves really really really really really really really really really slowly .	the queen was really really really really really really really really really slowly .
the king talks very very very very very very very very carefully .	the king is very very very very very very very very carefully .
the lady cries really really really really really really really really quickly .	the lady is really really really really really really really really quickly .
the king talks really really really really really really really carefully .	the king is really really really really really really really carefully .
the adult waves very very very very very very very very very carefully .	the adult is very very very very very very very very very carefully .
the guy sings really really really really really really really really really carefully .	the guy was really really really really really really really really really carefully .
the king sings very very very very very very very very very quietly .	the king is very very very very very very very very very quietly .
the girl paints very very very very very very very very very perfectly .	the girl is very very very very very very very very very perfectly .
the adult exercises very very very very very very very very very very quickly .	the adult is very very very very very very very very very very quickly .
the patient talks really really really really really really really really really quietly .	the patient was really really really really really really really really really quietly .
the queen cries really really really really really really really quietly .	the queen was really really really really really really really quietly .
the woman exercises really really really really really really really really carefully .	the woman is really really really really really really really really carefully .
the dancer exercises very very very very very very very very very very carefully .	the dancer is very very very very very very very very very very carefully .
the doctor paints really really really really really really really quickly .	the doctor was really really really really really really really quickly .
the teacher cries really really really really really really really really really really carefully .	the teacher was really really really really really really really really really really carefully .
the man exercises very very very very very very very very very very quickly .	the man was very very very very very very very very very very quickly .
the man sings very very very very very very very very slowly .	the man was very very very very very very very very slowly .
the doctor paints really really really really really really really really really really slowly .	the doctor was really really really really really really really really really really slowly .
the woman talks really really really really really really really really carefully .	the woman is really really really really really really really really carefully .
the boy talks really really really really really really really really really perfectly .	the boy is really really really really really really really really really perfectly .
the boy reads very very very very very very very very very very quickly .	the boy is very very very very very very very very very very quickly .
the patient paints very very very very very very very very very very perfectly .	the patient is very very very very very very very very very very perfectly .
the patient waves very very very very very very very very very quietly .	the patient is very very very very very very very very very quietly .
the girl waves really really really really really really really really quickly .	the girl was really really really really really really really really quickly .
the man waves really really really really really really really slowly .	the man is really really really really really really really slowly .
the dentist paints really really really really really really really really really carefully .	the dentist is really really really really really really really really really carefully .
the dentist exercises very very very very very very very very very slowly .	the dentist is very very very very very very very very very slowly .
the guy talks very very very very very very very very very perfectly .	the guy is very very very very very very very very very perfectly .
the girl talks very very very very very very very carefully .	the girl was very very very very very very very carefully .
the customer exercises really really really really really really really really perfectly .	the customer is really really really really really really really really perfectly .
the dancer waves very very very very very very very very very very carefully .	the dancer is very very very very very very very very very very carefully .
the man sings very very very very very very very very quickly .	the man is very very very very very very very very quickly .
the dancer paints really really really really really really really really really quickly .	the dancer was really really really really really really really really really quickly .
the patient sings very very very very very very very perfectly .	the patient is very very very very very very very perfectly .
the man exercises really really really really really really really carefully .	the man is really really really really really really really carefully .
the dentist talks really really really really really really really really really really quickly .	the dentist is really really really really really really really really really really quickly .
the driver waves really really really really really really really really perfectly .	the driver was really really really really really really really really perfectly .
the teacher talks very very very very very very very very quietly .	the teacher was very very very very very very very very quietly .
the man exercises really really really really really really really really really slowly .	the man is really really really really really really really really really slowly .
the boy reads very very very very very very very very very slowly .	the boy was very very very very very very very very very slowly .
the lady talks very very very very very very very quickly .	the lady is very very very very very very very quickly .
the driver reads really really really really really really really really really quickly .	the driver was really really really really really really really really really quickly .
the driver reads really really really really really really really really quietly .	the driver is really really really really really really really really quietly .
the patient talks really really really really really really really slowly .	the patient was really really really really really really really slowly .
the teacher sings really really really really really really really really really perfectly .	the teacher is really really really really really really really really really perfectly .
the teacher waves very very very very very very very very very very quietly .	the teacher was very very very very very very very very very very quietly .
the patient waves very very very very very very very quietly .	the patient is very very very very very very very quietly .
the dentist reads really really really really really really really really slowly .	the dentist is really really really really really really really really slowly .
the child paints very very very very very very very carefully .	the child was very very very very very very very carefully .
the king exercises very very very very very very very perfectly .	the king is very very very very very very very perfectly .
the man cries really really really really really really really really quietly .	the man is really really really really really really really really quietly .
the man sings very very very very very very very very very very quickly .	the man was very very very very very very very very very very quickly .
the dentist cries really really really really really really really really really really slowly .	the dentist is really really really really really really really really really really slowly .
the dentist cries really really really really really really really really really really perfectly .	the dentist was really really really really really really really really really really perfectly .
the man sings very very very very very very very very carefully .	the man was very very very very very very very very carefully .
the boy cries really really really really really really really really really perfectly .	the boy was really really really really really really really really really perfectly .
the queen reads really really really really really really really really really really perfectly .	the queen was really really really really really really really really really really perfectly .
the patient cries very very very very very very very very carefully .	the patient is very very very very very very very very carefully .
the girl cries really really really really really really really quietly .	the girl is really really really really really really really quietly .
the person sings very very very very very very very very very quickly .	the person is very very very very very very very very very quickly .
the driver sings very very very very very very very very very very carefully .	the driver is very very very very very very very very very very carefully .
the customer paints really really really really really really really really quietly .	the customer was really really really really really really really really quietly .
the guy paints really really really really really really really slowly .	the guy is really really really really really really really slowly .
the driver reads really really really really really really really really really really quietly .	the driver is really really really really really really really really really really quietly .
the girl paints very very very very very very very very slowly .	the girl was very very very very very very very very slowly .
the queen talks really really really really really really really quietly .	the queen was really really really really really really really quietly .
the queen paints very very very very very very very very very very quickly .	the queen was very very very very very very very very very very quickly .
the dentist cries very very very very very very very very very very perfectly .	the dentist was very very very very very very very very very very perfectly .
the boy talks really really really really really really really really really really slowly .	the boy is really really really really really really really really really really slowly .
the teacher paints really really really really really really really slowly .	the teacher is really really really really really really really slowly .
the dentist exercises really really really really really really really slowly .	the dentist is really really really really really really really slowly .
the boy cries very very very very very very very very very carefully .	the boy was very very very very very very very very very carefully .
the customer sings very very very very very very very very slowly .	the customer was very very very very very very very very slowly .
the dentist exercises very very very very very very very very perfectly .	the dentist was very very very very very very very very perfectly .
the girl sings very very very very very very very very slowly .	the girl is very very very very very very very very slowly .
the doctor exercises really really really really really really really really really really quickly .	the doctor is really really really really really really really really really really quickly .
the king talks really really really really really really really really slowly .	the king is really really really really really really really really slowly .
the doctor talks really really really really really really really really really really slowly .	the doctor was really really really really really really really really really really slowly .
the person exercises very very very very very very very very very perfectly .	the person is very very very very very very very very very perfectly .
the patient cries really really really really really really really really quietly .	the patient is really really really really really really really really quietly .
the teacher paints very very very very very very very very very very perfectly .	the teacher is very very very very very very very very very very perfectly .
the person waves really really really really really really really really really perfectly .	the person is really really really really really really really really really perfectly .
the boy cries really really really really really really really really slowly .	the boy is really really really really really really really really slowly .
the person sings really really really really really really really quietly .	the person was really really really really really really really quietly .
the dancer cries really really really really really really really really really really slowly .	the dancer is really really really really really really really really really really slowly .
the queen paints very very very very very very very very perfectly .	the queen is very very very very very very very very perfectly .
the driver sings very very very very very very very slowly .	the driver was very very very very very very very slowly .
the doctor exercises very very very very very very very very very very quickly .	the doctor is very very very very very very very very very very quickly .
the boy talks really really really really really really really really really quietly .	the boy is really really really really really really really really really quietly .
the child cries really really really really really really really really really slowly .	the child is really really really really really really really really really slowly .
the woman exercises very very very very very very very very quickly .	the woman is very very very very very very very very quickly .
the king sings really really really really really really really really slowly .	the king is really really really really really really really really slowly .
the child sings really really really really really really really really really perfectly .	the child was really really really really really really really really really perfectly .
the patient reads very very very very very very very perfectly .	the patient is very very very very very very very perfectly .
the man exercises really really really really really really really really really quietly .	the man is really really really really really really really really really quietly .
the queen cries really really really really really really really quickly .	the queen is really really really really really really really quickly .
the customer reads really really really really really really really really really carefully .	the customer is really really really really really really really really really carefully .
the lady waves very very very very very very very very very very carefully .	the lady is very very very very very very very very very very carefully .
the girl reads very very very very very very very very quietly .	the girl was very very very very very very very very quietly .
the man talks very very very very very very very very carefully .	the man is very very very very very very very very carefully .
the boy sings very very very very very very very slowly .	the boy is very very very very very very very slowly .
the girl reads very very very very very very very very very perfectly .	the girl was very very very very very very very very very perfectly .
the adult reads very very very very very very very very quickly .	the adult is very very very very very very very very quickly .
the guy sings really really really really really really really really really really perfectly .	the guy is really really really really really really really really really really perfectly .
the dancer cries very very very very very very very quietly .	the dancer was very very very very very very very quietly .
the adult cries really really really really really really really quietly .	the adult was really really really really really really really quietly .
the dentist reads really really really really really really really quickly .	the dentist is really really really really really really really quickly .
the driver waves very very very very very very very slowly .	the driver is very very very very very very very slowly .
the child exercises very very very very very very very very slowly .	the child is very very very very very very very very slowly .
the customer talks very very very very very very very very very very slowly .	the customer is very very very very very very very very very very slowly .
the queen cries really really really really really really really really really quietly .	the queen was really really really really really really really really really quietly .
the child sings really really really really really really really really really really quietly .	the child is really really really really really really really really really really quietly .
the woman talks really really really really really really really really really slowly .	the woman is really really really really really really really really really slowly .
the woman cries very very very very very very very quietly .	the woman is very very very very very very very quietly .
the adult waves really really really really really really really really really carefully .	the adult is really really really really really really really really really carefully .
the adult cries really really really really really really really really perfectly .	the adult is really really really really really really really really perfectly .
the boy sings really really really really really really really really really perfectly .	the boy is really really really really really really really really really perfectly .
the driver paints really really really really really really really really really really quietly .	the driver is really really really really really really really really really really quietly .
the child exercises really really really really really really really really really really quickly .	the child was really really really really really really really really really really quickly .
the dentist exercises really really really really really really really really slowly .	the dentist was really really really really really really really really slowly .
the doctor exercises really really really really really really really carefully .	the doctor is really really really really really really really carefully .
the adult paints really really really really really really really quickly .	the adult was really really really really really really really quickly .
the dancer sings really really really really really really really really really slowly .	the dancer was really really really really really really really really really slowly .
the woman cries very very very very very very very very very quickly .	the woman was very very very very very very very very very quickly .
the king waves really really really really really really really really really really carefully .	the king was really really really really really really really really really really carefully .
the lady sings really really really really really really really really really really slowly .	the lady was really really really really really really really really really really slowly .
the customer exercises really really really really really really really really quickly .	the customer was really really really really really really really really quickly .
the guy cries very very very very very very very quietly .	the guy is very very very very very very very quietly .
the woman paints really really really really really really really really really carefully .	the woman is really really really really really really really really really carefully .
the adult sings really really really really really really really really really slowly .	the adult is really really really really really really really really really slowly .
the guy talks very very very very very very very slowly .	the guy is very very very very very very very slowly .
the customer exercises really really really really really really really quickly .	the customer is really really really really really really really quickly .
the adult paints really really really really really really really really really really carefully .	the adult was really really really really really really really really really really carefully .
the woman waves very very very very very very very very very quickly .	the woman was very very very very very very very very very quickly .
the driver cries very very very very very very very very very quickly .	the driver was very very very very very very very very very quickly .
the person cries very very very very very very very very very slowly .	the person was very very very very very very very very very slowly .
the customer waves really really really really really really really really really quickly .	the customer is really really really really really really really really really quickly .
the guy waves really really really really really really really really really really quietly .	the guy was really really really really really really really really really really quietly .
the woman sings very very very very very very very quickly .	the woman was very very very very very very very quickly .
the queen sings really really really really really really really really carefully .	the queen was really really really really really really really really carefully .
the dentist cries really really really really really really really really really really quietly .	the dentist is really really really really really really really really really really quietly .
the queen paints really really really really really really really really really really carefully .	the queen was really really really really really really really really really really carefully .
the king sings very very very very very very very very very very quickly .	the king was very very very very very very very very very very quickly .
the driver waves really really really really really really really really really really perfectly .	the driver is really really really really really really really really really really perfectly .
the dancer reads very very very very very very very carefully .	the dancer was very very very very very very very carefully .
the customer reads very very very very very very very very very very perfectly .	the customer is very very very very very very very very very very perfectly .
the lady sings very very very very very very very very quietly .	the lady was very very very very very very very very quietly .
the dancer paints very very very very very very very slowly .	the dancer is very very very very very very very slowly .
the dentist paints really really really really really really really carefully .	the dentist was really really really really really really really carefully .
the person reads really really really really really really really perfectly .	the person was really really really really really really really perfectly .
the man paints very very very very very very very very very quietly .	the man is very very very very very very very very very quietly .
the customer waves very very very very very very very very perfectly .	the customer is very very very very very very very very perfectly .
the dentist reads really really really really really really really really really perfectly .	the dentist was really really really really really really really really really perfectly .
the girl reads very very very very very very very very quickly .	the girl is very very very very very very very very quickly .
the doctor sings very very very very very very very very very very slowly .	the doctor is very very very very very very very very very very slowly .
the king sings really really really really really really really really really perfectly .	the king was really really really really really really really really really perfectly .
the teacher exercises really really really really really really really really quietly .	the teacher was really really really really really really really really quietly .
the driver sings really really really really really really really really really carefully .	the driver was really really really really really really really really really carefully .
the man talks very very very very very very very very very perfectly .	the man was very very very very very very very very very perfectly .
the woman paints really really really really really really really really really really carefully .	the woman was really really really really really really really really really really carefully .
the king reads really really really really really really really really slowly .	the king is really really really really really really really really slowly .
the person sings really really really really really really really really really really quietly .	the person is really really really really really really really really really really quietly .
the patient exercises very very very very very very very very very very slowly .	the patient was very very very very very very very very very very slowly .
the dancer talks very very very very very very very carefully .	the dancer was very very very very very very very carefully .
the king cries really really really really really really really really really really carefully .	the king was really really really really really really really really really really carefully .
the person waves very very very very very very very very very very slowly .	the person was very very very very very very very very very very slowly .
the child cries very very very very very very very very very perfectly .	the child was very very very very very very very very very perfectly .
the dentist reads really really really really really really really slowly .	the dentist is really really really really really really really slowly .
the girl waves very very very very very very very very very quietly .	the girl was very very very very very very very very very quietly .
the boy sings very very very very very very very very very slowly .	the boy is very very very very very very very very very slowly .
the man waves really really really really really really really really really really quickly .	the man was really really really really really really really really really really quickly .
the child talks very very very very very very very very very quickly .	the child is very very very very very very very very very quickly .
the king sings very very very very very very very very slowly .	the king was very very very very very very very very slowly .
the guy waves really really really really really really really really carefully .	the guy was really really really really really really really really carefully .
the king exercises really really really really really really really perfectly .	the king was really really really really really really really perfectly .
the teacher cries very very very very very very very very perfectly .	the teacher is very very very very very very very very perfectly .
the boy exercises very very very very very very very perfectly .	the boy is very very very very very very very perfectly .
the king paints very very very very very very very slowly .	the king is very very very very very very very slowly .
the adult waves really really really really really really really perfectly .	the adult is really really really really really really really perfectly .
the dentist exercises very very very very very very very carefully .	the dentist is very very very very very very very carefully .
the doctor cries very very very very very very very very slowly .	the doctor was very very very very very very very very slowly .
the man cries very very very very very very very very very very carefully .	the man was very very very very very very very very very very carefully .
the adult waves very very very very very very very very very very quietly .	the adult is very very very very very very very very very very quietly .
the boy cries really really really really really really really really really slowly .	the boy was really really really really really really really really really slowly .
the driver sings really really really really really really really really really quietly .	the driver was really really really really really really really really really quietly .
the dentist waves very very very very very very very quietly .	the dentist was very very very very very very very quietly .
